0 13 21 b
0 0 0 0 0
#####################
#p      f  b  s     # 
#                   #   
#x      #*#*#*#     # 
#       *  1  *     # 
#       #  2  #     # 
#x      *  3  *     # 
#       #  4  #     # 
#       *  5  *     # 
#       #*#*#*#     # 
#                   # 
#                   # 
#####################