1 13 31 b
6 4 0 0 0 
###############################
#p  *   * *   * *  *      b   #
# # # #*#*# # # # # # # # #*# #
# *   *    **    *x*     *   *#
# #*# # # # # # # # # # #*#*# #
#                 1   *2 1    #
# # # # # # #*#*# # #*#*# # #*#
#  *  *  *  *       * **  * 11#
# # # # # #*# # # # # # #*#1#x#
#   *   * **** ** *2*   *  *2 #
#*# # # # # #1# # # #*#*#*# # #
# *     **     *            *2#
###############################
