1 13 31 b
6 4 0 0 0 
###############################
#p *       *  **    *    *  * #
# #b# # #*# #*#*# # # # # #*# #
#       *  *       **        *#
# # # # # # # # # # # #*#*# #*#
#  *   * *    2 * *      *x   #
#*# # # # #1# # # # # # # #*# #
# * *              1  *  1 2  #
#*# # #*#*#*# #*#*# # # # #*# #
#      *   **  *11  x   1     #
# # #*# # # # #*#2# #*# #*# # #
#* *    *        *  2 **    * #
###############################
