3 13 35 b
8 5 3 2 0 
###################################
#p    **  *     *  * * ***        #
# # #x# # # # # # # # #*# #*# #*# #
#           * *  *   **    * *    #
# # #*# # # # #*#*#*#*# # # # #*# #
#*   * **3   *    *  2***   *11   #
# # #*#*#2# #*# # # # # #1# #*#*#*#
#   b* * * *x 2    4  ** *  *     #
# #*#1# # #*# # # # # # # #1#*# # #
#         *   *       *   2* **   #
#*# # # #2#*#*# #*# #*#*#1#1# # # #
#    4 ***    3*   * 3  1   ***** #
###################################
