2 13 31
###############################
#p   **     **      *        *#
# #*# # # # # #*# # # # # #*# #
#*           *   *  ** *  * * #
#*#*# # # # #*#*# #*#*# # # #*#
#  *       *  *    * *        #
#*# # # # #*# #*# # # # # # #*#
#    * * *         *    **    #
#*# #*# # # #x#*# # # # #*# #*#
#*   *            *      *x   #
# # # # #*# # # # # # # # #*#*#
#    **   * *    *   * *   *  #
###############################
