2 13 33 f
8 5 2 0 0 
#################################
#p   ****   *    *    **   *    #
# # # # # # # # #x# # # # # # # #
#* *  **   *   **  **  *     *  #
# # # # # #*# # # # # # #*# # # #
#  *   *1x *   * 2*     ** 11  *#
# # # #*#*#*#*# #*# #*# #*# # #1#
#*** **  ** 2   2        * *    #
# #f# # # #1# # # # #3# # # # # #
#     *        * * *****2  * 1  #
# # # # # # # # # # #1# #*#*# # #
#    **2   3     *1    ***      #
#################################
