1 13 31 b
6 4 0 0 0 
###############################
#p  *          *** *   ***    #
# #*#*#*# #*#*# #*#*# #*# # #x#
#   *         * ***  **   * * #
# # # # # # # # # # # # # # #*#
#  *       **       1*    *  *#
# # # #*# # #1#*# # # # # # # #
#     *      *   2   1** *2   #
# # #*# # #*# # # # # # # # # #
#*    *   ** 2       *      1 #
#x#*# # # # #*#*# # # # # # # #
# b*    1   *   *         2 1 #
###############################
