2 13 35 f
8 5 2 0 0 
###################################
#p    ***   **       *  *   *  *  #
# # # # # # #*# # #*# #*# # #*# #*#
#     *     *  *   *         *   *#
#*#*# # #*#*# #*# # # # #*# #*# # #
# *      *  *   *  *2     *    f  #
# # # # # # #*#*# #1# # #*#*# # # #
#  *   * *  *  1    *  * x      **#
# # # #*#2#*# # # # # #*#*# #x# # #
#   *    2  * *** 1 * *12  *  *1  #
# # #*#1# #3#*# #*# # # # # # # # #
#  **        ** * 1  *  1**2    *3#
###################################
