2 13 33 f
8 5 2 0 0 
#################################
#p           f*  * * *   *  ** *#
# #*# # #*# # # #*# #*# #*#*# #*#
#* *        *  *      **      * #
#*# # # #*# #*#*# # # # # # # # #
# *      *12      x* * **     * #
# #*# #*# # # # # #*#*#*# # # # #
#*   1 * 3   *  *  1     *  ** *#
# # # # # #*#*# # # # #*#1# # #2#
#     **  *    2    **131* * * *#
#*# # # # # # # #*#2#*# # # # # #
#*    2  1  * *     *     x1   *#
#################################
