1 13 31 b
6 4 0 0 0 
###############################
#p  *         *   *        ***#
# # #*# #*# # # #*# # # # #*# #
#*     *  * * *  **    *  ** *#
#*# # # # #*# # # # #*#*#*# #*#
#               ** *  *2  * * #
# # #*# # # # # # #*# #*#*#*#*#
#**  2 *      * x1 * *x       #
# #b# # # # # # #*# # # # # # #
# *    1*  **   1   *    *1 * #
#*#*# #*# #2#*# # #*#*# # #*# #
#   *1    *    1         2    #
###############################
