2 13 35 f
8 5 2 0 0 
###################################
#p       *  *   *   *   *    ***  #
# # # # # # # #*#*# # #*# # # # # #
#          * *        * ***  *    #
#*# # # # # # # # # # # # #x# #*# #
# * **      *                * *1 #
# # # # #1# # # #1# #*# # # # # # #
#  *   *  x   *     *             #
# # # #2#*# # #*# # #*#2# # # #2# #
#*  *      *    3  *1  *       *  #
# # # # # #1#*#2# # # # # # #3#*#*#
#   *     1**  12 *   *      ** *1#
###################################
