1 13 31 b
6 4 0 0 0 
###############################
#p  *    * *   b * ** **  * **#
# # # # # # # #*#*# # # #*# #*#
#*        **   **      **   * #
#*# # #*# # # #*# #*# # # # # #
# *x *       *        2* **  *#
# # # # #*#*# #*#*# #*# # # #*#
#  *  **x*       *  **   *  2 #
# # #2#*# # #*#2# #1# #*#*# #1#
#*   *   *      *   * *       #
#*#*#*#*# # # #*#*# # # # #1# #
# *   *1   1 *     1 **    * *#
###############################
