2 13 33 f
8 5 2 0 0 
#################################
#p   * *    * x      *  **      #
# # # # # # # # # #*#*# # # #*# #
#  *    *   *  *               *#
#*# # # #*#*#*#*# # # # # # # # #
#    * *  x* 1* ** *   3     1 *#
#*# #*#1#2# #3#*# # #*# #*#*# #*#
#*  *  * * 2  1     * * 1    * *#
# # #*#*# # # # #*#*#1# # # # # #
#     *    2  **      * * *12*  #
#*# # # # #*#*# # # # # # # # #*#
# f    2 *   *   * ***      1*  #
#################################
