3 13 35 b
8 5 3 2 0 
###################################
#p      x       *            x*   #
# # # #*# # # # # # #*#*# # # #*# #
#       *  ** * *  *   *  *  *    #
# # # #*# # # # # # # # # # # # # #
#   *** *  2* **     * * 1   *3   #
# #*#*#3#*# # #1# # # # #*# # #*# #
#  * 2**1   13  * 12**       **   #
# #*# # # # # # # #*# # # # #4# # #
#    * * *        *   *1 *   4  * #
#*# # #*#*# #*# #1# #*#*# # # # # #
#  **      1  *  b    *       *22 #
###################################
