2 13 35
8 5 2 0 0 
###################################
#p **         * **  *      * *    #
# # #*#*# #*# # #*#*# # # #*# # # #
#     *x ***  *      *   *    * * #
# # # # # #*# #*# # # # # # # #*# #
#* *  * 1 2*  ***    3  * x* 12   #
# #*# # # #*# # #*# #*#*# # #*#*# #
#*  *  **  *  * *  2* ** 1 *  1   #
# # #*#*# #*#1# # #*# # #*# # # # #
#         1 **2   ***   *  3 **   #
# # # # #2# # # # #*# # # # #*# # #
#  *      *      * *  ***1** 1*   #
###################################
