1 13 31
10 5 0 0 0 
##########
#p       #
# # #*# ##
# * *    #
#*# # # ##
#  * 11*x#
# # #*#1##
#    21**#
#*# #*#1##
#  * 221*#
# # #1#1##
#  **2121#
##########
