2 13 33 f
8 5 2 0 0 
###################################
#p  *  *  * ** *  *   *  * *  *** #
# # # #*# # # # # # #*# # # # # # #
#    ** *   *   *   *         * * #
# #*# # # # # # # # # # # #*#*# # #
# *  * 1  * *   *  **   *   * *2  #
# #*# #*#f#*#*# # # # # # #1# #*# #
#     1  3   * 3* *2 *  *      *  #
# # # #*# # # # # # #2# # #*# # # #
# * ** *  *    11     **  *   **2 #
# #*# # # # #*# # # #*# #*# #*# # #
#   * 2 1**  *x ***1    *   1   * #
###################################
