1 13 31 b
6 4 0 0 0 
###############################
#p   *              *  *   * *#
# # # # #*#*#*# # # #x#*#*# # #
# *   *         *          *  #
# # # # # #x# #*#b# # # # # # #
# *       **  *        *   *  #
# # # #*# #*# # # # # # # # #*#
#**  2 * 1 2      2  * *  *   #
#*# # # # #*# # # # # # #*# # #
#  ** *  *  * *    *     1  * #
# #*# #*# # # #*# # #*#1#*#*#1#
#       *  1  * 1        * 2  #
###############################
