2 13 35 f
8 5 2 0 0 
###################################
#p     *     * *   *             *#
# # #*# #x# # # # # #*#*# # # # # #
#  *   * **           *           #
# #*# # # #*# # # # #*# #x#*# # # #
# *   * *   ***      *  2      1 *#
#*# # # #*#*# # # # #*#*# #*#*# #*#
#    ****       *  **   1      1  #
#*#*# # # # #*#*# # # # #2# # # # #
#     *3*   ** *  1*     2 * 11*  #
#*# # # # #*# # # # # # #*#2# # # #
#f   *     32  ** 11*    * ** *   #
###################################
