1 13 31 b
6 4 0 0 0 
###############################
#p **   *        * *      **  #
# #*# # #*#*# #*# # #*# # # # #
#*    **        *        *    #
# # # # # #*# # # # # # #*#b# #
#       1 2*   * *   *      11#
# #*# # # # # # #*# #*# #*# # #
#   **  ***2    *   ***    ** #
#*# #2#x#1# # # # # # # #*#*# #
#  *  * *  *   * 1   *  * *   #
# #*#*# # #*# # # #*# # # #2# #
#   ** *1* *     ** x*     *  #
###############################
