2 13 35 f
8 5 2 0 0 
###################################
#p * *        * *      *   ** *   #
# # # # # # # #x# # # # # #*# #*#*#
#* ****    *     **    * **   **  #
# # # # #*# # # # # # # # # # # # #
#        3    1  *         1* * **#
#*# #*# # # #3# # # # # #2# # #*# #
#*    1        *     2     2    * #
# # # # #*# #*# #*# # # # # # #1#*#
#      ****2    *       *    1 1x #
# # # #*#*# # #*# #*# #*#1# # # # #
#   *  **               **2 * 1  f#
###################################
