1 13 31
6 4 0 0 0 
###############################
#p            **    *** *   * #
# # # #*#x#*# # # #*#*# #*# #*#
# *  *     * *        *****   #
# # #*# # # # #*# #*# # # # # #
#   * 1    * *2 **     *   * 1#
# # # #2# # # #*# # #*#*# # # #
#        1***   *      *      #
# #*# # # # #*#*# # #1#*#*#1# #
# **   *  *** * **   2  2  2  #
# # # # #x# #*#1#*#1# # # #*# #
#    ***     11*  *  *1*     *#
###############################
