1 13 31
6 4 0 0 0 
###############################
#p *    * *  *    **     x  **#
# #*# # # # # #*#*#*# #*# # # #
#            * * *    *x   *  #
# # # # #*#*# # #*# #*#*# # # #
#*    *       ** *   2    2  *#
# # # # # #2# # #*#1# # #1# # #
#      **  **1 12 * *   * *   #
#*# #*# # #*# # #*# #*# # # # #
#    * 1  *  *          * *  *#
# # # # # # #*#1# # # # # # # #
#* *  *       * *     ***     #
###############################
