1 13 31 b
6 4 0 0 0 
###############################
#p  *     *  *  *x   *      * #
# # #*# # #*#*# # # # # # # # #
#     * *    *     *    * *   #
# #*# # # # # #*# # # #*#*#*# #
# *   *     *   * *      21*  #
# #*# # # #*# # #*# # # # # # #
#* *     *  *  ** * *2   2   x#
#*# #2# # # #*#*#1# # # # # # #
#   *** *    * *  1* *  **   1#
#*# # # #b#*#*# # #*# #*#*#*# #
#     *     * *       1 *  *1 #
###############################
