1 13 31 b
6 4 0 0 0 
###############################
#p               x *        **#
# # #*# # # # # # #*#*#*# # # #
#  *       * *    *  * *    * #
# # # # # # #*# # #b#*# # # #*#
#  * * *    2       *  *  **  #
#*#*# # #*#*#*# # #*# # #*#*#*#
#  *  x***   **  * * * ***   *#
# # #2# # #*# # # # # # # # #*#
#    1 *   **    1 * **12     #
#*# #*#*# # #2# #1#1# # # #*# #
#    *  * *     1    *    **  #
###############################
