1 13 31 b
6 4 0 0 0 
###############################
#p         b* *    * **       #
# #*# #*# # # # #*# # #*# # # #
#    b* *   *  *     *        #
#*#*# # # # # #*#*# # # # # #*#
#  * *       *  *   x* *     *#
#*#*#b#*# # # # # #*# # #*#*#*#
#    *  *   *  *  ** * * * ***#
# # # # # #*# # #*# # # #*# # #
#*       *    *   **   *  *   #
# # # # # # # # # # # # # # # #
# **  **     *    *   x  *   *#
###############################
