2 13 33 f
8 5 2 0 0 
#################################
#p   *       **        *        #
# # # # # # # # # # #*# # # # #*#
#    ** *** *      *       *    #
# #*# # # #*# # # # # #*# #f#*# #
#**  *  *     *12    *   * *  *1#
# # #2#*# # # #*# #1# #2#*# #*#1#
#     **3    **    * 2 *  1 **  #
# # #*#*# #*# # # # # #1# # # # #
#      3 * ** *      x **  11* *#
#x#*#*#*#*# #*#*# #2#*# # #*# # #
#    * *      **  ** ** *    *  #
#################################
