1 13 31 b
6 4 0 0 0 
###############################
#p    x*** *  * *  ***        #
# # # # # # # # #*# # # #*#*#*#
#       *           *         #
# # # # # # #*# # # # #*#*# # #
#***   * *          *   1 *  *#
# #*# # #1#*#*#*#2# # # #*# # #
#  * **** 2* 2* * *   * *  *  #
# # # #*#*#*# # # # # #*# # # #
# **  *   1      *   *1  *  **#
# # # # # # # # # # # # #b#*#1#
#* x * **     *1 2    *   *   #
###############################
