2 13 35
8 5 2 0 0 
###################################
#p  ***           *   **     *  * #
# #*# # #*#*# # # #*# # # #*#*# # #
#    *  *     x       * *       * #
# #*# #*# # #*#*# # # # # # # # # #
#       2 1  *           ** * **1 #
# #*# # #*# #*#*# # # #*#*# # # # #
#       * * *   *   * *  *   *  **#
# # #*# #*# # # # # #*# # # # #*#*#
#    *** 3         *   **1  ** ** #
# # # # # #*# # # # # # #*# #*# # #
# ***    *x*  ****      2         #
###################################
