3 13 35 b
8 5 3 2 0 
###################################
#p  *   *        b*       * *  *  #
# # # #*# #*# # # # # #*#*# # # #x#
#  *                 *   *        #
# #*# # #*# # # # # #*# # #*# # #*#
#* x  *  *    2*  41   **  *1**   #
# #*# # #3# # # # # # # #*#*#*# # #
#   *          1    *  ** 1       #
# #*#1#*#1# # #*#2# # # #3# #*#4# #
#       *  *2 3 **        ** ** *2#
# # # # # # # # # # #2# # #*#1# # #
# *  *1** ** **       *       * * #
###################################
